Fergie feat. Ludacris — Glamorous
Real Life — Send Me An Angel '89
Corona — The Rhythm of the Night (Rapino Bros. 7" Single)
Kelly Rowland — Work (Freemasons Remix)
Simply Red — Something Got Me Started (Hurley's House Mix)
Robert Howard & Kym Mazelle — Wait
Backstreet Boys — I Want It That Way
Dirty Vegas — Days Go By
Moloko — The Time Is Now
Amerie — 1 Thing
Robbie Williams & Kylie Minogue — Kids
Maroon 5 feat. Christina Aguilera — Moves Like Jagger
N-Joi — Anthem
Wham! — Everything She Wants
Mis-Teeq — Scandalous
Mike Posner — Cooler Than Me (Single Mix)
Lady Gaga — Applause
All Saints — Pure Shores
Jamiroquai — Alright
Modjo — Lady (Hear Me Tonight)
Lorde — Tennis Court
Taylor Dayne — Tell It to My Heart
Sly Fox — Let's Go All the Way
Robyn feat. Kleerup — With Every Heartbeat
Bobby Brown — On Our Own
INXS — New Sensation
Naked Eyes — Promises, Promises
M.I.A. — Bad Girls
Hall & Oates — Adult Education
Sneaker Pimps — 6 Underground
Rihanna — Only Girl (In the World)
Britney Spears — Gimme More
The Black Eyed Peas — Meet Me Halfway
Gorillaz feat. De La Soul — Feel Good Inc.
Living In A Box — Living In A Box
M83 — Midnight City
Bronski Beat — Smalltown Boy
Morcheeba — Tape Loop (Later replaced by Shortcheeba Mix)
Morcheeba — Tape Loop (Shortcheeba Mix)
Pet Shop Boys — West End Girls
Cassie — Me & U
Jane Child — Don't Wanna Fall In Love
Stardust — Music Sounds Better With You
Neon Trees — Animal
Cobra Starship feat. Sabi — You Make Me Feel...
Belinda Carlisle — Circle in the Sand
Tears For Fears — Everybody Wants to Rule the World
Miike Snow — Animal
Wilson Phillips — Hold On
Michael Jackson — Jam (Not entirely confirmed)
Jamiroquai — Love Foolosophy
Olivia Newton-John — Physical
Enrique Iglesias feat. Pitbull — I Like It
Estelle feat. Kanye West — American Boy
Kevin Rudolf feat. Lil Wayne — Let It Rock
Duran Duran — Serious
Seal — Future Love Paradise
Timbaland feat. Keri Hilson & D.O.E — The Way I Are
Kylie Minogue — Surrender
Supermen Lovers — Starlight